16 19 WWWWWWWWWWWWWWWWWWWWWPWWWWFFFFFFFWFFFWWFBBFFFBBFFBFBFGGGWWFFBBBWFFFFBFFWGGGWWFBFFFWFBBFBBFWGGGWWWWFFFWFFBFFFFWGGGWWFFFFFWFBFBFBFWGGGWWFFFFWWWWWWFWWWGGGWWWFWFFWFFBFBFFWGGGWWFFWWFWFBBFBFBWWGGWWFGGWFWFFBFFFFFFWGWWFGGWFWFBBBFBBBFWGWWWWWWFWFFFFFFFWFWGWWWWWWFWWWWWWWWWFWGWWWWWWFFFFFFFFFFFWGWWWWWWWWWWWWWWWWWWWW