10 25 WWWWWWWWWWWWWWWWWWWWWWWWWWFFFFFFFFFFFFFFFFFFFFFFFWWFGFFFFFFFFFFFFFFFFFFFFFWWFFFFFFFFFFFFFFFFWFFFFFFWWFBFFFFFWFFFFFFFFFFFFFFFWWFPFFFFFFFFFFFFFFFFFFFFFWWFFFFFFFFFFFFFFFFFFFFFFFWWFFFFFFFFFFFFFFFFFFFFFFFWWFFFFFFFFFFFFFFFFFFFFFFFWWWWWWWWWWWWWWWWWWWWWWWWWW