10 17 WWWWWWWWWWWWWWWWWWWWWWWWWWFFFFFPWWWWWWWWWWWFBWBFWWWWWWWWWWWWFBFFBWWWWWWWWWWWWWBFBFWWWWWWWWWWWWFBFWFWWWWGGGGFFWWFBFFBFFWWWGGGFFFFBFFBFFFWWGGGGFFWWWWWWWWWWWWWWWWWWWWWWWWWWW