14 19 WWWWWWWWWWWWWWWWWWWWWWWWWWWWWWWFFGGGGWWWWWWWWWWWWWFFGGGGWWFFFFWFFBFBFFFGGGGWWFBBBWBFFBFWFFGGGGWWFFBFFFFFBFWFFGGGGWWFBBFWBFBFBWWWWWWWWWFFBFWFFFFFWWWWWWWWWWFWWWWWWWWWWWWWWWWWFFFFWFFFFWWWWWWWWWWFFFFFBFFFWWWWWWWWWWFFBBWBBFFPWWWWWWWWWFFFFWFFFFWWWWWWWWWWWWWWWWWWWWWWWWWWWW