13 17 WWWWWWWWWWWWWWWWWWWWWWWWWWFFFWWWWWWWWWWWWWWFWBWWFFWWWWWWWWWWFFFFFBFWWWWWWWWWWFWWWFFFWWGGGGFFWWFBFFBWWWWGGGGFFFFBFBBFWWWWGGGGFFWWBFFBFPWWWWWWWWWWWFFBFFWWWWWWWWWWWWFBFBFFWWWWWWWWWWWWWFWWFWWWWWWWWWWWWWFFFFWWWWWWWWWWWWWWWWWWW