11 12 WWWWWWWWWWWWWGGFFWWWWPWWWGGFFWWWFFFWWGGFFFFFBBFWWGGFFWFWFBFWWGGWWWFWFBFWWWWWFBFWBFFWWWWWFFBWFBFWWWWWFBFFBFFWWWWWFFWWFFFWWWWWWWWWWWWW