12 13 WWWWWWWWWWWWWWWWWWWWWFFFWWWWFWFPWWFBBFWWFFFFBFFFFFFWWFFBFFWWWFFFWWWWFWWWWWBWWWWFBFFWWWFGGWWWFBFBFBFGGGWWWFFFFWWWGGGWWWFBBFWWWGGGWWWFFWWWWWWWWWWWWWWWWWWWWWWW