14 17 WWWWWWWWWWWWWWWWWWWWWWWWWWWWFFGGGWWWWWWWWWWWWFFGGGWWWWWWWWFFFFFFGFGWWWWWWWWFFWWFFGGGWWWWWWWWWFWWFFGGGWWWWWWWWWFWWWWWWWWWWWWWWFBBBFWWWWWWWWWWWWFFBFBFWWWWWWWFFFWBFBFFFWFFFWWPFBFFBFFFFBFFBFWWWWWWWFBBFBFWWWWWWWWWWWFFFFFFWWWWWWWWWWWWWWWWWWWWWW